Wake up, Count Dorklok! You are here. In the City. Eight hours of train travel almost made you forget why you are here in the first place. Let me remind you! The rent is not gonna pay itself and Chief Redd needs you to help him find out some information. You see, there has been a robbery - at the blood bank! There is only one suspect profile and you guessed it. It's a vampire. Now, why would they send you - a humble police station database manager - to such a mission? Well, you're the only nerd in the police station interested enough in all this vampiric stuff. Like, remember how you wore a cape and fake fangs in middle school? Or tried to sue Twilight Saga for false depiction? Anyhow, now you are a detective. Good luck!

DP Projekt 2025
An Interactive Fiction by Klara kaulj
Release 1 / Serial number 250117 / Inform 7 build 6M62 (I6/v6.33 lib 6/12N) SD

New Volterra - City Centre
The City of New Volterra is a, heh, lively metropolitan area inhabited by both people and nightfolk. Nightfolk include vampires, werewolves, ghouls, and many others. Like any other bigger city, New Volterra has its troubles such as the rise of dark magic, criminal organizations, and corruption. Other than that, it's a lovely place enriched with various cultures. The City Centre consists of a Main square surrounded by shops and many other businesses. A beautiful gothic fountain is the centerpiece of this square, and north of it lies The City Council building. As a young detective from down south, you begin to feel a bit overwhelmed.

You can see a note, Morgana and Sigmund here.

>New Volterra - City Centre
That's not a verb I recognise.

>New Volterra - City Centre
That's not a verb I recognise.

* * *

>examine note
Find Victor. He will give you directions and provide you with equipment. His shop is in City Centre.

>examine Morgana
A tall and muscular woman with red hair and bunch of tattoos. Dressed in all black with platform boots that make her even taller. Phew!

>ask Morgana about Victor
Morgana: There's 50 million citizens here and you ask me about some Victor? Geez, might as well drop a needle in the hay.

* * *

>ask Sigmund about Victor
Victor: Yeah, he's right "round this corner. But watch out he is, like, weird and stuff.

* * *

>Go to Victor's workshop
You can't see any such thing.

>go west
Victor's workshop
Victor is an engineer. He makes weapons and various other tools used by police and military. It's rumored that he also pracitces some kind of magic, but you are not the one to fall for rumors, are you? The workshop reeks of garlic.

You can see Victor Volturi, a key, a chest (closed), Garlic bread and a gun here.

>talk to Victor Volturi
That's not a verb I recognise.

>examine Victor Volturi
Short and fat man with greasy dark hair. He is wearing some kind of weird goggles.

>say Greetings to Victor Volturi
"Who sent you here kid?" Victor asks.

>give Victor Volturi the note
You can't see any such thing.

>inventory
You are carrying:
  a notebook

>pocket
That's not a verb I recognise.

>give note to Victor Volturi
You can't see any such thing.

>go back
You can't see any such thing.

>go est
You can't see any such thing.

>go east
New Volterra - City Centre
The City of New Volterra is a, heh, lively metropolitan area inhabited by both people and nightfolk. Nightfolk include vampires, werewolves, ghouls, and many others. Like any other bigger city, New Volterra has its troubles such as the rise of dark magic, criminal organizations, and corruption. Other than that, it's a lovely place enriched with various cultures. The City Centre consists of a Main square surrounded by shops and many other businesses. A beautiful gothic fountain is the centerpiece of this square, and north of it lies The City Council building. As a young detective from down south, you begin to feel a bit overwhelmed.

You can see a note, Morgana and Sigmund here.

>take note
You slip the note into your pocket.

>examine note
Find Victor. He will give you directions and provide you with equipment. His shop is in City Centre. Info: Victor Volturi, West City Centre 45, NV - Redd

>note 1
That's not a verb I recognise.

>inventory
You are carrying:
  a note 1
  a notebook

>go wesr
You can't see any such thing.

>go west
Victor's workshop
Victor is an engineer. He makes weapons and various other tools used by police and military. It's rumored that he also pracitces some kind of magic, but you are not the one to fall for rumors, are you? The workshop reeks of garlic.

You can see Victor Volturi, a key, a chest (closed), Garlic bread and a gun here.

>give note to Victor Volturi
Victor takes the note and reads it. He points his finger up and then left. It's pointing to a chest

>ask Victor Volturi about weapons
"I have been crafting guns, swords, daggers, cannons and buncha other knicknacks for over 90 years now using only the finest materials there are."

>give note to Victor Volturi
You can't see any such thing.

>ask Victor Volturi about weapons
"I have been crafting guns, swords, daggers, cannons and buncha other knicknacks for over 90 years now using only the finest materials there are."

>ask Victor Volturi about the chest
"I don't have much to say about that," Victor grumbles, returning to his work.

>ask Victor Volturi about chest
"That chest over there? It contains some of my finest creations. But only those with the right key can open it."

>ask Victor Volturi about key
"20 bucks, take it or leave it."
"What do you want to do next?"
1. "Pay the $20 and buy the key."
2. "Try to haggle."
3. "Never mind."

>2
Victor frowns. "No haggling. 20 bucks, take it or leave it."

>3
That's not a verb I recognise.

>2
That's not a verb I recognise.

>ask Victor Volturi about key
"20 bucks, take it or leave it."
"What do you want to do next?"
1. "Pay the $20 and buy the key."
2. "Try to haggle."
3. "Never mind."

>3
Victor shrugs and goes back to work.

>ask Victor Volturi about key
"20 bucks, take it or leave it."
"What do you want to do next?"
1. "Pay the $20 and buy the key."
2. "Try to haggle."
3. "Never mind."

>1
Victor takes the $20 and hands you a rusty key. "Good choice," he says.

>inventory
You are carrying:
  a key
  a notebook

>ask Victor Volturi about key
"20 bucks, take it or leave it."
"What do you want to do next?"
1. "Pay the $20 and buy the key."
2. "Try to haggle."
3. "Never mind."

* * *

>1
Victor takes the $20 and hands you a rusty key. "Good choice," he says.

>exmaine key
That's not a verb I recognise.

>examine key
A rusty key. That you payed 20 bucks for. 20 bucks for rusty key.

>open chesz
You can't see any such thing.

>open chest
The chest is locked. You can't open it without the key.

>ask Victor Volturi about chest
"That chest over there? It contains some of my finest creations. But only those with the right key can open it."

>ask about key
You can't see any such thing.

>ask Victor Volturi about key
"20 bucks, take it or leave it."
"What do you want to do next?"
1. "Pay the $20 and buy the key."
2. "Try to haggle."
3. "Never mind."

* * *

>inventory
You are carrying:
  a key
  a notebook

>unlock chest with kex
You can't see any such thing.

>unlock chest with key
You insert the key into the lock and turn it. The chest is now unlocked.

>take key
You already have that.

>unlock chest with key
You insert the key into the lock and turn it. The chest is now unlocked.

>take treasure
You can't see any such thing.

>open chest
You open the chest and find a something inside. You take the grab and close the chest again.

>inventory
You are carrying:
  a garlic
  a key
  a notebook

>examine treasure
You can't see any such thing.

>open chest
The chest is locked. You can't open it without the key.

>take key
You already have that.

* * *

>unlock chest with key
You insert the key into the lock and turn it. The chest is now unlocked.

>open chest
You open the chest and find a something inside. You take the grab and close the chest again.

* * *

>inventory
You are carrying:
  a garlic
  a key
  a notebook

>examine garlicy stake
You can't see any such thing.

>ask Victor Volturi about garlicy stake
"I don't have much to say about that," Victor grumbles, returning to his work.

>inventory
You are carrying:
  a garlic
  a key
  a notebook

>examine notebook
You review your notes:You haven't written down any clues yet.

I beg your pardon?

>examine room
You can't see any such thing.

>ask Victor Volturi about garlic bread
"My lovely wife baked some this morning. It's delicious. Help yourself!"

>take garlic bread
You jot down the details of "Garlic bread" in your notebook.

>examine notebook
You review your notes:Garlic bread: Vampires don't really like garlic - must suck if they are Italian.

>examine Victor's workshop
You can't see any such thing.

* * *

>take note
You slip the note into your pocket.

* * *

>examine note
Find Victor. He will give you directions and provide you with equipment. His shop is in City Centre. Info: Victor Volturi, West City Centre 45, NV - Redd

>ask Morgana about Victor
Morgana: There's 50 million citizens here and you ask me about some Victor? Geez, might as well drop a needle in the hay.

>ask Morgana about Victor Volturi
Morgana: Right, he collabs with the cops. A traitor if you ask me!

>ask Sigmund about Victor
Victor: Yeah, he's right "round this corner - westside. But watch out he is, like, weird and stuff.

>go west
Victor's workshop
Victor is an engineer. He makes weapons and various other tools used by police and military. It's rumored that he also pracitces some kind of magic, but you are not the one to fall for rumors, are you? The workshop reeks of garlic.

You can see Victor Volturi, a key, a chest (closed), Garlic bread and a gun here.

>ask Victor Volturi about a gun
"I don't have much to say about that," Victor grumbles, returning to his work.

>ask Victor Volturi about gun
"Take it. It's made for you. Your boss payed me up front."

>take gun
Taken.

>examine gun
A shiny revolver that uses silver bullets  and deals 6 damage- Van Hellsing style.

>inventory
You are carrying:
  a gun
  a note 1
  a notebook

>go east
New Volterra - City Centre
The City of New Volterra is a, heh, lively metropolitan area inhabited by both people and nightfolk. Nightfolk include vampires, werewolves, ghouls, and many others. Like any other bigger city, New Volterra has its troubles such as the rise of dark magic, criminal organizations, and corruption. Other than that, it's a lovely place enriched with various cultures. The City Centre consists of a Main square surrounded by shops and many other businesses. A beautiful gothic fountain is the centerpiece of this square, and north of it lies The City Council building. As a young detective from down south, you begin to feel a bit overwhelmed.

You can see Morgana and Sigmund here.

>go east
Bloodless Nest
You step into a dimly lit chamber with stone walls covered in ancient carvings. Faint whispers echo through the halls, and the air smells of iron and decay. It's hard to shake the feeling that you're being watched.

You can see an ancient relict here.

I beg your pardon?

>go east
East Wing
The East Wing is a narrow corridor with flickering torches casting long shadows. You see several ornate doors along the walls, some ajar, revealing what looks like storage rooms.

You can see a blood sample here.

>go back
You can't see any such thing.

>go west
Bloodless Nest
You step into a dimly lit chamber with stone walls covered in ancient carvings. Faint whispers echo through the halls, and the air smells of iron and decay. It's hard to shake the feeling that you're being watched.

You can see an ancient relict here.

>move player to The New Volterra - City Centre
You can't see any such thing.

>.
That's not a verb I recognise.

* * *

>examine note
Find Victor. He will give you directions and provide you with equipment. His shop is in City Centre. Info: Victor Volturi, West City Centre 45, NV - Redd

>inventory
You are carrying:
  a note 1
  a notebook

>go south
Slums
Poor side of the town. Streets are crowded with various folk. Mechants are selling all kinds of things. There are a couple of bars, as well.

>go west
Market
Lively area filled with vendors and interesting things.

You can see Cecilia, Gaiman, an onions, a Book of The Undead and a Blood Pudding here.

>examine Cecilia
A mysterious figure in long black dress and big sunglasses.

>examine Cecilia
A mysterious figure in long black dress and big sunglasses.

>examine Cecilia
A mysterious figure in long black dress and big sunglasses.
The sun sets, and the city grows quiet as night falls.

>examine Cecilia
Mhm, yep, that's a vampire.

>examine Gaiman
Short and fat man that sells a variety of things. You can buy something from him by asking him about merch

>ask Gaiman about Merch
"Damn right I got merch. Buy your heart out kid."
"No haggling.."
1. "Onions"
2. "Book of The Undead"
3. "Blood Pudding"

>1
Market is closed at night.

>ask gaiman about vampires
"All I know that there is one they call King and that I try to stay away from them."

>ask Gaiman about vampires
"All I know that there is one they call King and that I try to stay away from them."

>ask Gaiman about vampires
"All I know that there is one they call King and that I try to stay away from them."

>ask Gaiman about vampires
"All I know that there is one they call King and that I try to stay away from them."
The sun rises, and the city starts to stir again.

>ask Gaiman about vampires
"All I know that there is one they call King and that I try to stay away from them."

I beg your pardon?

>examine Cecilia
A mysterious figure in long black dress and big sunglasses.

>2
Victor frowns. "No haggling. 20 bucks, take it or leave it."

>3
....

>4
That's not a verb I recognise.

* * *

>go south
Slums
Poor side of the town. Streets are crowded with various folk. Merchants are selling all kinds of things. There are a couple of bars, as well.

You can see Beggar here.

>go east
Hells Bells
A pub that welcomes nightfolk and all of the others.

You can see a wooden door, Patrik Noah and Isidora here.

>go west
Slums
Poor side of the town. Streets are crowded with various folk. Mechants are selling all kinds of things. There are a couple of bars, as well.

>go north
New Volterra - City Centre
The City of New Volterra is a, heh, lively metropolitan area inhabited by both people and nightfolk. Nightfolk include vampires, werewolves, ghouls, and many others. Like any other bigger city, New Volterra has its troubles such as the rise of dark magic, criminal organizations, and corruption. Other than that, it's a lovely place enriched with various cultures. The City Centre consists of a Main square surrounded by shops and many other businesses. A beautiful gothic fountain is the centerpiece of this square, and north of it lies The City Council building. As a young detective from down south, you begin to feel a bit overwhelmed.

You can see a note, Morgana and Sigmund here.

>ask Morgana about Victor
Morgana: There's 50 million citizens here and you ask me about some Victor? Geez, might as well drop a needle in the hay.

* * *

>ask Morgana about Victor Volturi
Morgana: Right, he collabs with the cops. A traitor if you ask me!

>ask Sigmund about Victor Volturi
There is no reply.

>take note
You slip the note into your pocket.

>ask Sigmund about Victor
Victor: Yeah, he's right "round this corner - westside. But watch out he is, like, weird and stuff.

The sun sets, and the city grows quiet as night falls.

>go east
Bloodless Nest
You step into a dimly lit chamber with stone walls covered in ancient carvings. Faint whispers echo through the halls, and the air smells of iron and decay. It's hard to shake the feeling that you're being watched.

You can see an ancient relict here.

>go east
East Wing
The East Wing is a narrow corridor with flickering torches casting long shadows. You see several ornate doors along the walls, some ajar, revealing what looks like storage rooms.

You can see Grog and a blood sample here.

>examine Grog
The vampire steps out of the shadows, its eyes glowing red.

>examine Grog
The vampire steps out of the shadows, its eyes glowing red.

* * *

>go east
Hells Bells
A pub that welcomes nightfolk and all of the others.

You can see a wooden door, Patrik Noah and Isidora here.

>ask Patrik Noah about vampires
"Aw man they are cool, sometimes they gather in my pub and order Bloody Marys - extra blood." Patrik winks and hands you a small rusty key. "You might need this." he says.

>inventory
You are carrying:
  a notebook

>ask Patrik Noah about vampires
"Aw man they are cool, sometimes they gather in my pub and order Bloody Marys - extra blood." Patrik winks and hands you a small rusty key. "You might need this." he says.

>examine vault key
The vault key looks rusty and small, definitely important for unlocking something.

>inventory
You are carrying:
  a notebook

>unlock wooden door
(with the notebook)
That doesn't seem to fit the lock.

>unlock wooden door with vault key
(first taking the vault key)
Eeek, the wooden door unlocks.

The sun sets, and the city grows quiet as night falls.

>enter the door
(first opening the wooden door)

Secret Room
This is some sort of an archive.

You can see a wooden door and a shiny scroll here.

>examine shiny scroll
If you wish to become a creature of the night, you shall come to me mortal and I shall grant you your wish. Come to my nest, little bird. Fear me not.

>take shiny scroll
You jot down the details of "shiny scroll" in your notebook.

>notebook
That's not a verb I recognise.

>examine notebook
You review your notes:shiny scroll: If you wish to become a creature of the night, you shall come to me mortal and I shall grant you your wish. Come to my nest, little bird. Fear me not.

>go back
You can't see any such thing.

>go west
Hells Bells
A pub that welcomes nightfolk and all of the others.

You can see a wooden door, Patrik Noah and Isidora here.

>ask Isidora about vampire
"Leave me alone, mortal."

>examine Isidora
Mhm, yep, that's a vampire.

>go west
Slums
Poor side of the town. Streets are crowded with various folk. Mechants are selling all kinds of things. There are a couple of bars, as well.

>go north
1. Introduction and City of New Volterra 
The sun rises, and the city starts to stir again.

>go west
Victor's workshop
Victor is an engineer. He makes weapons and various other tools used by police and military. It's rumored that he also pracitces some kind of magic, but you are not the one to fall for rumors, are you? The workshop reeks of garlic.

You can see Victor Volturi, a workshop key, a chest (closed), Garlic bread and a gun here.

>examine Garlic bread
Vampires don't really like garlic - must suck if they are Italian.

>take garlic bread
You jot down the details of "Garlic bread" in your notebook.

>examine notebook
You review your notes:shiny scroll: If you wish to become a creature of the night, you shall come to me mortal and I shall grant you your wish. Come to my nest, little bird. Fear me not.
Garlic bread: Vampires don't really like garlic - must suck if they are Italian.

>ask Victor Volturi about chest
"That chest over there? It contains some of my finest creations. But only those with the right key can open it."

* * *

>1
Victor takes the $20 and hands you a rusty key. "Good choice," he says.

>inventory
You are carrying:
  a workshop key
  Garlic bread
  a shiny scroll
  a vault key
  a notebook

>open chest
The chest is locked. You can't open it without the key.

>unlock chest with workshop key
You insert the key into the lock and turn it. The chest is now unlocked.

The sun sets, and the city grows quiet as night falls.

>open chest
You open the chest and find a something inside. You take the grab and close the chest again.

>examine chest
A massive wooden chest. God knows what's in it.

>inventory
You are carrying:
  a garlic
  a workshop key
  Garlic bread
  a shiny scroll
  a vault key
  a notebook

>examine garlix
You can't see any such thing.

>examine garlic
Which do you mean, the garlic or Garlic bread?

>the garlix
You can't see any such thing.

>the garlic
That's not a verb I recognise.

>examine the garlic
Which do you mean, the garlic or Garlic bread?

>garlic
Which do you mean, the garlic or Garlic bread?

>the garlic
Which do you mean, the garlic or Garlic bread?

>examine the garlic
Which do you mean, the garlic or Garlic bread?

>examine the garlic bread
Vampires don't really like garlic - must suck if they are Italian.

>take garlic
Which do you mean, the garlic or Garlic bread?

>go east
1. Introduction and City of New Volterra

>go north
You can't go that way.

>go west
Victor's workshop
Victor is an engineer. He makes weapons and various other tools used by police and military. It's rumored that he also pracitces some kind of magic, but you are not the one to fall for rumors, are you? The workshop reeks of garlic.

You can see Victor Volturi, a chest (closed) and a gun here.

>go east
1. Introduction and City of New Volterra

>go east
3. The final decision 
The sun rises, and the city starts to stir again.

>examine a grand vampire
A powerful and terrifying creature, the grand vampire stands tall with glowing red eyes and sharp fangs, exuding dark energy.

>kill grand vampire
You need both a gun and garlic to kill the grand vampire!

>kill grand vampire
You need both a gun and garlic to kill the grand vampire!

>ask grand vampire about eternal life
"DO YOU WISH TO LIVE IT?"
"The choice is yours, kid."
1. "Become a vampire."
2. "Bring justice - Kill him."
3. "Do nothing."

>3
Victor shrugs and goes back to work.

* * *

>go east
Hells Bells
A pub that welcomes nightfolk and all of the others.

You can see a wooden door, Patrik Noah and Isidora here.

>ask Patrik Noah about himself
"Don't know, guess I am really passionate about cocktails, tattoos and computers. Ever heard of this band - King Gizzard? They are so cool. " Patrik yapps.

>examine Patrik Noah
A quriky bartender working in the pub. He collects gossip and rumours.

>go west
Slums
Poor side of the town. Streets are crowded with various folk. Mechants are selling all kinds of things. There are a couple of bars, as well.

* * *

>examine
(the notebook)
You review your notes:You haven't written down any clues yet.

>go north
You can't go that way.

>go east
Bloodless Nest
You step into a dimly lit chamber with stone walls covered in ancient carvings. Faint whispers echo through the halls, and the air smells of iron and decay. It's hard to shake the feeling that you're being watched.

You can see a mirror and a grand vampire here.

The sun sets, and the city grows quiet as night falls.

>go east
East Wing
The East Wing is a narrow corridor with flickering torches casting long shadows. You see several ornate doors along the walls, some ajar, revealing what looks like storage rooms.

You can see Grog and a blood sample here.

>examine Grog
Mhm, yep, that's a vampire.

I beg your pardon?

I beg your pardon?

>kill Grog
Violence isn't the answer to this one.

>attack Grog
Violence isn't the answer to this one.

I beg your pardon?

>go east
You can't go that way.

>go west
Bloodless Nest
You step into a dimly lit chamber with stone walls covered in ancient carvings. Faint whispers echo through the halls, and the air smells of iron and decay. It's hard to shake the feeling that you're being watched.

You can see a mirror and a grand vampire here.

>go east
East Wing
The East Wing is a narrow corridor with flickering torches casting long shadows. You see several ornate doors along the walls, some ajar, revealing what looks like storage rooms.

You can see Grog and a blood sample here.

>go west
Bloodless Nest
You step into a dimly lit chamber with stone walls covered in ancient carvings. Faint whispers echo through the halls, and the air smells of iron and decay. It's hard to shake the feeling that you're being watched.

You can see a mirror and a grand vampire here.

>go west
West Wing
The West Wing is a wide hallway with a vaulted ceiling and stained-glass windows that let in pale moonlight. At the end of the hall, a locked iron door catches your attention.

You can see a torn document here.

The sun rises, and the city starts to stir again.

>leave
But you aren't in anything at the moment.

* * *

>go south
Slums
Poor side of the town. Streets are crowded with various folk. Merchants are selling all kinds of things. There are a couple of bars, as well.

You can see Beggar here.

>go west
Market
Lively area filled with vendors and interesting things.

You can see Cecilia, Gaiman, an onions, a Book of The Undead and a Blood Pudding here.

>ask Gaiman about the merch
"..."

>ask Gaiman about Merch
"Damn right I got merch. Buy your heart out kid."
"No haggling.."
1. "Onions"
2. "Book of The Undead"
3. "Blood Pudding"

>1
Good choice!

>inventory
You are carrying:
  an onions
  a notebook

>eat onions
That's plainly inedible.

>go east
Slums
Poor side of the town. Streets are crowded with various folk. Merchants are selling all kinds of things. There are a couple of bars, as well.

You can see Beggar here.

>examine Beggar
Poor thing, looks like he hasn't eaten a thing in a while. Maybe I should offer to feed him something?

>feed Beggar onions
Beggar doesn't seem interested.

The sun sets, and the city grows quiet as night falls.

>feed Beggar with onions
You feed Beggar with Onions. He is devouring them like apples."I haven't eaten this good since the vampires held me hostage in the Nest. Can you belive that they tried to feast of off me?" He speaks with his mouth full. "Here look at this photo of me and the King."

>inventory
You are carrying:
  Photograph
  an onions
  a notebook

>examine photograph
A strange photo of this man standing next to nothing? I guess vampires are not visible in the photos, huh.

>examine photograph
A strange photo of this man standing next to nothing? I guess vampires are not visible in the photos, huh.

>inventory
You are carrying:
  Photograph
  an onions
  a notebook

>examine notebook
You review your notes:You haven't written down any clues yet.

>go north
New Volterra - City Centre
The City of New Volterra is a, heh, lively metropolitan area inhabited by both people and nightfolk. Nightfolk include vampires, werewolves, ghouls, and many others. Like any other bigger city, New Volterra has its troubles such as the rise of dark magic, criminal organizations, and corruption. Other than that, it's a lovely place enriched with various cultures. The City Centre consists of a Main square surrounded by shops and many other businesses. A beautiful gothic fountain is the centerpiece of this square, and north of it lies The City Council building. As a young detective from down south, you begin to feel a bit overwhelmed.

You can see a note, Morgana and Sigmund here.

>go east
Bloodless Nest
You step into a dimly lit chamber with stone walls covered in ancient carvings. Faint whispers echo through the halls, and the air smells of iron and decay. It's hard to shake the feeling that you're being watched.

You can see a mirror and a grand vampire here.

>ask grand vampire about eternal life
"DO YOU WISH TO LIVE IT?"
"The choice is yours, kid."
1. "Become a vampire."
2. "Bring justice - Kill him."
3. "Do nothing."

The sun rises, and the city starts to stir again.

>1
Victor takes the $20 and hands you a rusty key. "Good choice," he says.

>1
Victor takes the $20 and hands you a rusty key. "Good choice," he says.

>inventory
You are carrying:
  a workshop key
  Photograph
  an onions
  a notebook

* * *

>ask Morgana about vampires
"We don't see them much as they usually stay in Bloodless Nest. At least their elite."

>talk to Morgana about vampires
That's not a verb I recognise.

>go south
Slums
Poor side of the town. Streets are crowded with various folk. Mechants are selling all kinds of things. There are a couple of bars, as well.

>go east
Hells Bells
A pub that welcomes nightfolk and little less of others.

You can see a wooden door, Patrik Noah and Isidora here.

>ask Patrik Noah about himself
"Don't know, guess I am really passionate about cocktails, tattoos and computers. Ever heard of this band - King Gizzard? They are so cool. " Patrik yapps.

>ask Patrik Noah about vampires
"Aw man they are cool, sometimes they gather in my pub and order Bloody Marys - extra blood." Patrik winks and hands you a small rusty key. "You might need this." he says.

>ask Isidora about vampires
"Leave me alone, mortal."

>ask Patrik Noah about vampires
"Aw man they are cool, sometimes they gather in my pub and order Bloody Marys - extra blood." Patrik winks and hands you a small rusty key. "You might need this." he says.

>ask Isidora about vampires
"Stop bothering me."

>ask Isidora about vampires
"Mortals can be so annoying."

The sun sets, and the city grows quiet as night falls.

>ask Isidora about vampires
"Mortals can be so annoying."

>examine Isidora
Mhm, yep, that's a vampire.

>ask Isidora about vampires
"Mortals can be so annoying."

>ask Isidora about vampires
"Mortals can be so annoying."

>ask Isidora about vampires
"Mortals can be so annoying."

The sun rises, and the city starts to stir again.

>examine Isidora
Strangely attractive woman with black hair and red eyes.

>examine wooden door
You see nothing special about the wooden door.

>ask Isidora about vampires
"Mortals can be so annoying."

>ask Isidora about door
"Mortals can be so annoying."

>examine Patrik Noah
A quriky bartender working in the pub. He collects gossip and rumours.

>ask Isidora about door
"Mortals can be so annoying."

>go west
Slums
Poor side of the town. Streets are crowded with various folk. Mechants are selling all kinds of things. There are a couple of bars, as well.

>go north
1. Introduction and City of New Volterra 
The sun sets, and the city grows quiet as night falls.

>go south
Slums
Poor side of the town. Streets are crowded with various folk. Mechants are selling all kinds of things. There are a couple of bars, as well.

* * *

>go east
Hells Bells
A pub that welcomes nightfolk and little less of others.

You can see a wooden door, Patrik Noah and Isidora here.

>open wooden door
It seems to be locked.

>ask Patrik Noah about vampires
"Aw man they are cool, sometimes they gather in my pub and order Bloody Marys - extra blood." Patrik winks and hands you a small rusty key. "You might need this." he says.

* * *

>inventory
You are carrying:
  a notebook

>examine notebook
You review your notes:You haven't written down any clues yet.

>ask Patrik Noah about vampires
"Aw man they are cool, sometimes they gather in my pub and order Bloody Marys - extra blood." Patrik winks and hands you a small rusty key. "You might need this." he says.
The sun rises, and the city starts to stir again.

>inventory
You are carrying:
  a notebook

* * *

>go east
Bloodless Nest
You step into a dimly lit chamber with stone walls covered in carvings. Faint whispers echo through the halls, and the air smells of iron and decay. It's hard to shake the feeling that you're being watched.

You can see a mirror here.

>ask grand vampire about eternal life
You can't see any such thing.

>1
Victor takes the $20 and hands you a rusty key. "Good choice," he says.

>ask grand vampire about eternal life
You can't see any such thing.

* * *

>ask grand vampire about eternal life
You can't see any such thing.

* * *

>restart
*** You have chosen to join the Bloodless Nest. Come to me little bird. Your blood is now belongs to the night. ***

Would you like to RESTART, RESTORE a saved game, QUIT or UNDO the last command?

>restart
Wake up, Count Dorklok! You are here. In the City. Eight hours of train travel almost made you forget why you are here in the first place. Let me remind you! The rent is not gonna pay itself and Chief Redd needs you to help him find out some information. You see, there has been a robbery - at the blood bank! There is only one suspect profile and you guessed it. It's a vampire. Now, why would they send you - a humble police station database manager - to such a mission? Well, you're the only nerd in the police station interested enough in all this vampiric stuff. Like, remember how you wore a cape and fake fangs in middle school? Or tried to sue Twilight Saga for false depiction? Anyhow, now you are a detective. Good luck!

DP Projekt 2025
An Interactive Fiction by Klara kaulj
Release 1 / Serial number 250117 / Inform 7 build 6M62 (I6/v6.33 lib 6/12N) SD

New Volterra - City Centre
The City of New Volterra is a, heh, lively metropolitan area inhabited by both people and nightfolk. Nightfolk include vampires, werewolves, ghouls, and many others. Like any other bigger city, New Volterra has its troubles such as the rise of dark magic, criminal organizations, and corruption. Other than that, it's a lovely place enriched with various cultures. The City Centre consists of a Main square surrounded by shops and many other businesses. A beautiful gothic fountain is the centerpiece of this square, and north of it lies The City Council building. As a young detective from down south, you begin to feel a bit overwhelmed.

You can see a note, Morgana and Sigmund here.

>go east
Bloodless Nest
You step into a dimly lit chamber with stone walls covered in carvings. Faint whispers echo through the halls, and the air smells of iron and decay. It's hard to shake the feeling that you're being watched.

You can see a mirror here.

>take mirror
You jot down the details of "mirror" in your notebook.

>examine mirror
I look unrecognizable.

>go east
East Wing
The East Wing is a narrow corridor with flickering torches casting long shadows. You see several ornate doors along the walls, some ajar, revealing what looks like storage rooms.

You can see Grog and a blood sample here.

>examine gorg
You can't see any such thing.

>examine Gorg
You can't see any such thing.

>examine Grog
Hideous creature - Sunken eyes, and slimey pale skin. His entire existance yearns for some blood.

>ask Grog about vampires
There is no reply.

>ask Grog about King
I have been a servant to my King for the past 348 years. For centuries he searched for a place to settle and then he ran into this. He has made a home for all of us.

>ask Grog about cirme
There is no reply.

>ask Grog about crime
There is no reply.

The sun sets, and the city grows mystic as night falls.

>ask Grog about blood bank
All the blood banks in this city have put Vampire Proof doors so we can't come in. The blood bank in your town is the only one they invited us in. If you ask me, a total violation of security.

>give Grog Blood Pudding
I only understood you as far as wanting to give Grog the blood sample.

>go west
Bloodless Nest
You step into a dimly lit chamber with stone walls covered in carvings. Faint whispers echo through the halls, and the air smells of iron and decay. It's hard to shake the feeling that you're being watched.

>go west
West Wing
The West Wing is a wide hallway with a vaulted ceiling and stained-glass windows that let in pale moonlight. At the end of the hall, a locked iron door catches your attention.

You can see an Iron Door and a torn document here.

>go east
Bloodless Nest
You step into a dimly lit chamber with stone walls covered in carvings. Faint whispers echo through the halls, and the air smells of iron and decay. It's hard to shake the feeling that you're being watched.

>go west
West Wing
The West Wing is a wide hallway with a vaulted ceiling and stained-glass windows that let in pale moonlight. At the end of the hall, a locked iron door catches your attention.

You can see an Iron Door and a torn document here.

* * *

>go east
Bloodless Nest
You step into a dimly lit chamber with stone walls covered in carvings. Faint whispers echo through the halls, and the air smells of iron and decay. It's hard to shake the feeling that you're being watched.

>go back
You can't see any such thing.

>go west
West Wing
The West Wing is a wide hallway with a vaulted ceiling and stained-glass windows that let in pale moonlight. At the end of the hall, a locked iron door catches your attention.

You can see an Iron Door and a torn document here.

* * *

>go east
Bloodless Nest
You step into a dimly lit chamber with stone walls covered in carvings. Faint whispers echo through the halls, and the air smells of iron and decay. It's hard to shake the feeling that you're being watched.

>go north
You can't go that way.

The sun rises, and the city starts to stir again.

>go to The New Volterra - City Centre
You need the teleportation stone to teleport!

* * *

>ask Sigmund about Vampires
Victor whispers: "You going to the Nest? As a friend, let me give you a little something." He hands you a crystal.

>inventory
You are carrying:
  a teleportation stone
  a notebook

>examine teleportation stone
You see nothing special about the teleportation stone.

>go souht
You can't see any such thing.

>go south
Slums
Poor side of the town. Streets are crowded with various folk. Merchants are selling all kinds of things. There are a couple of bars, as well.

You can see Beggar here.

>examine Beggar
Poor thing, looks like he hasn't eaten a thing in a while. Maybe I should offer to feed him something?

>go east
Hells Bells
A pub that welcomes nightfolk and all of the others.

You can see a wooden door, Patrik Noah and Isidora here.

>go west
Slums
Poor side of the town. Streets are crowded with various folk. Merchants are selling all kinds of things. There are a couple of bars, as well.

You can see Beggar here.

>go west
Market
Lively area filled with vendors and interesting things.

You can see Cecilia, Gaiman, an onions, a Book of The Undead and a Blood Pudding here.

>examine Cecilia
A mysterious figure in long black dress and big sunglasses.
The sun sets, and the city grows mystic as night falls.

>examine Cecilia
Mhm, yep, that's a vampire.

* * *

>examine Gaiman
Short and fat man that sells a variety of things. You can buy something from him by asking him about merch

>ask Gaiman about merch
"Damn right I got merch. Buy your heart out kid."
"No haggling.."
1. "Onions"
2. "Book of The Undead"
3. "Blood Pudding"

>1
Market is closed at night.

>examine Gaiman
Short and fat man that sells a variety of things. You can buy something from him by asking him about merch

>examine Gaiman
Short and fat man that sells a variety of things. You can buy something from him by asking him about merch

>examine Gaiman
Short and fat man that sells a variety of things. You can buy something from him by asking him about merch

The sun rises, and the city starts to stir again.

>ask Gaiman about merch
"Damn right I got merch. Buy your heart out kid."
"No haggling.."
1. "Onions"
2. "Book of The Undead"
3. "Blood Pudding"

>1
Good choice!

>inventory
You are carrying:
  an onions
  a teleportation stone
  a notebook

>go west
You can't go that way.

>go east
Slums
Poor side of the town. Streets are crowded with various folk. Merchants are selling all kinds of things. There are a couple of bars, as well.

You can see Beggar here.

>feed Beggar onions
Beggar doesn't seem interested.

>feed Beggar with Onions
You feed Beggar with Onions. He is devouring them like apples."I haven't eaten this good since the vampires held me hostage in the Nest. Can you belive that they tried to feast of off me?" He speaks with his mouth full. "Here look at this photo of me and the King."

>inventory
You are carrying:
  Photograph
  an onions
  a teleportation stone
  a notebook

>examine Photograph
A strange photo of this man standing next to nothing? I guess vampires are not visible in the photos, huh.

>ask Beggar about vampires
There is no reply.

The sun sets, and the city grows mystic as night falls.

>go east
Hells Bells
A pub that welcomes nightfolk and all of the others.

You can see a wooden door, Patrik Noah and Isidora here.

>examine Isidora
Mhm, yep, that's a vampire.

>ask Isidora about vampires
"Leave me alone, mortal."

* * *

>ask Patrik Noah about vampires
"Aw man they are cool, sometimes they gather in my pub and order Bloody Marys - extra blood." Patrik winks and hands you a small rusty key. "You might need this." he says.

>examine rusty key
You can't see any such thing.

>examine key
The vault key looks rusty and small, definitely important for unlocking something.

>go east
(first opening the wooden door)
It seems to be locked.

>unlock wooden door
What do you want to unlock the wooden door with?

>unlock wooden door with Vault key
(first taking the vault key)
Eeek, the wooden door unlocks.

>open wooden door
You open the wooden door.

>go in
You can't go that way.

The sun rises, and the city starts to stir again.

>go east
Secret Room
This is some sort of an archive.

You can see a wooden door and a shiny scroll here.

>examine a shiny scroll
If you wish to become a creature of the night, you shall come to me mortal and I shall grant you your wish. Come to my nest, little bird. Fear me not.

>go west
Hells Bells
A pub that welcomes nightfolk and all of the others.

You can see a wooden door, Patrik Noah and Isidora here.

>go west
Slums
Poor side of the town. Streets are crowded with various folk. Merchants are selling all kinds of things. There are a couple of bars, as well.

You can see Beggar here.

>go north
New Volterra - City Centre
The City of New Volterra is a, heh, lively metropolitan area inhabited by both people and nightfolk. Nightfolk include vampires, werewolves, ghouls, and many others. Like any other bigger city, New Volterra has its troubles such as the rise of dark magic, criminal organizations, and corruption. Other than that, it's a lovely place enriched with various cultures. The City Centre consists of a Main square surrounded by shops and many other businesses. A beautiful gothic fountain is the centerpiece of this square, and north of it lies The City Council building. As a young detective from down south, you begin to feel a bit overwhelmed.

You can see a note, Morgana and Sigmund here.

>take note
You slip the note into your pocket.

* * *

>examine note
Find Victor. He will give you directions and provide you with equipment. His shop is in City Centre. Info: Victor Volturi, West City Centre 45, NV - Redd

>go west
Victor's workshop
Victor is an engineer. He makes weapons and various other tools used by police and military. It's rumored that he also pracitces some kind of magic, but you are not the one to fall for rumors, are you? The workshop reeks of garlic.

You can see Victor Volturi, a workshop key, a chest (closed), Garlic bread and a gun here.

>examine workshop key
A rusty key. That you payed 20 bucks for. 20 bucks for rusty key.

The sun sets, and the city grows mystic as night falls.

>ask Victor Volturi about vampires
"I don't have much to say about that," Victor grumbles, returning to his work.

>ask Victor Volturi about weapons
"I have been crafting guns, swords, daggers, cannons and buncha other knicknacks for over 90 years now using only the finest materials there are."

>ask Victor Volturi about gun
"Take it. It's made for you. Your boss payed me up front."

>ask Victor Volturi about chest
"That chest over there? It contains some of my finest creations. But only those with the right key can open it."

* * *

>1
Victor takes the $20 and hands you a rusty key. "Good choice," he says.

>inventory
You are carrying:
  a workshop key
  a note 1
  a vault key
  Photograph
  an onions
  a teleportation stone
  a notebook

>open chest with workshop key
You insert the key into the lock and turn it. The chest is now unlocked.

>open chest
You open the chest and find a something inside. You take the grab and close the chest again.

>inventory
You are carrying:
  a garlic
  a workshop key
  a note 1
  a vault key
  Photograph
  an onions
  a teleportation stone
  a notebook

The sun rises, and the city starts to stir again.

>go east
New Volterra - City Centre
The City of New Volterra is a, heh, lively metropolitan area inhabited by both people and nightfolk. Nightfolk include vampires, werewolves, ghouls, and many others. Like any other bigger city, New Volterra has its troubles such as the rise of dark magic, criminal organizations, and corruption. Other than that, it's a lovely place enriched with various cultures. The City Centre consists of a Main square surrounded by shops and many other businesses. A beautiful gothic fountain is the centerpiece of this square, and north of it lies The City Council building. As a young detective from down south, you begin to feel a bit overwhelmed.

You can see Morgana and Sigmund here.

>go east
Bloodless Nest
You step into a dimly lit chamber with stone walls covered in carvings. Faint whispers echo through the halls, and the air smells of iron and decay. It's hard to shake the feeling that you're being watched.

You can see a mirror here.

* * *

>take mirror
You jot down the details of "mirror" in your notebook.

>go east
East Wing
The East Wing is a narrow corridor with flickering torches casting long shadows. You see several ornate doors along the walls, some ajar, revealing what looks like storage rooms.

You can see Grog and a blood sample here.

>examine Grog
Hideous creature - Sunken eyes, and slimey pale skin. His entire existance yearns for some blood.

* * *

>ask Grog about King
I have been a servant to my King for the past 348 years. For centuries he searched for a place to settle and then he ran into this. He has made a home for all of us.

>go west
Bloodless Nest
You step into a dimly lit chamber with stone walls covered in carvings. Faint whispers echo through the halls, and the air smells of iron and decay. It's hard to shake the feeling that you're being watched.

>go west
West Wing
The West Wing is a wide hallway with a vaulted ceiling and stained-glass windows that let in pale moonlight. At the end of the hall, a locked iron door catches your attention.

You can see an Iron Door and a torn document here.

The sun sets, and the city grows mystic as night falls.

>examine torn document
A fragment of parchment with faded writing in a strange language. But I can feel it calling me.

>examine notebook
You review your notes:mirror: I look unrecognizable.

>go east
Bloodless Nest
You step into a dimly lit chamber with stone walls covered in carvings. Faint whispers echo through the halls, and the air smells of iron and decay. It's hard to shake the feeling that you're being watched.

* * *

>go west
West Wing
The West Wing is a wide hallway with a vaulted ceiling and stained-glass windows that let in pale moonlight. At the end of the hall, a locked iron door catches your attention.

You can see an Iron Door and a torn document here.

>take torn document
You jot down the details of "torn document" in your notebook.

>go south
You feel unprepared to face the Grand Vampire. Perhaps you should gather more evidence before proceeding.

>go north
You can't go that way.

>go east
Bloodless Nest
You step into a dimly lit chamber with stone walls covered in carvings. Faint whispers echo through the halls, and the air smells of iron and decay. It's hard to shake the feeling that you're being watched.

>go west
West Wing
The West Wing is a wide hallway with a vaulted ceiling and stained-glass windows that let in pale moonlight. At the end of the hall, a locked iron door catches your attention.

You can see an Iron Door here.

The sun rises, and the city starts to stir again.

>go to New Volterra - City centre
New Volterra - City Centre
The City of New Volterra is a, heh, lively metropolitan area inhabited by both people and nightfolk. Nightfolk include vampires, werewolves, ghouls, and many others. Like any other bigger city, New Volterra has its troubles such as the rise of dark magic, criminal organizations, and corruption. Other than that, it's a lovely place enriched with various cultures. The City Centre consists of a Main square surrounded by shops and many other businesses. A beautiful gothic fountain is the centerpiece of this square, and north of it lies The City Council building. As a young detective from down south, you begin to feel a bit overwhelmed.

You can see Morgana and Sigmund here.

The teleportation stone glows, and the world blurs. When your vision clears, you find yourself in the New Volterra - City Centre.

>go south
Slums
Poor side of the town. Streets are crowded with various folk. Merchants are selling all kinds of things. There are a couple of bars, as well.

You can see Beggar here.

>go west
Market
Lively area filled with vendors and interesting things.

You can see Cecilia, Gaiman, a Book of The Undead and a Blood Pudding here.

>go east
Slums
Poor side of the town. Streets are crowded with various folk. Merchants are selling all kinds of things. There are a couple of bars, as well.

You can see Beggar here.

>go west
Market
Lively area filled with vendors and interesting things.

You can see Cecilia, Gaiman, a Book of The Undead and a Blood Pudding here.

* * *

>go east
Slums
Poor side of the town. Streets are crowded with various folk. Merchants are selling all kinds of things. There are a couple of bars, as well.

You can see Beggar here.

>go east
Hells Bells
A pub that welcomes nightfolk and all of the others.

You can see a wooden door, Patrik Noah and Isidora here.

* * *

>ask Patrik Noah about vampires
"Aw man they are cool, sometimes they gather in my pub and order Bloody Marys - extra blood." Patrik winks and hands you a small rusty key. "You might need this." he says.

>inventory
You are carrying:
  a torn document
  a mirror
  a garlic
  a workshop key
  a note 1
  a vault key
  Photograph
  an onions
  a teleportation stone
  a notebook

The sun sets, and the city grows mystic as night falls.

>go east
Secret Room
This is some sort of an archive.

You can see a wooden door and a shiny scroll here.

>take shiny scroll
You jot down the details of "shiny scroll" in your notebook.

>go east
You can't go that way.

>go wets
You can't see any such thing.

>go west
Hells Bells
A pub that welcomes nightfolk and all of the others.

You can see a wooden door, Patrik Noah and Isidora here.

* * *

>go west
Slums
Poor side of the town. Streets are crowded with various folk. Merchants are selling all kinds of things. There are a couple of bars, as well.

You can see Beggar here.

>go north
New Volterra - City Centre
The City of New Volterra is a, heh, lively metropolitan area inhabited by both people and nightfolk. Nightfolk include vampires, werewolves, ghouls, and many others. Like any other bigger city, New Volterra has its troubles such as the rise of dark magic, criminal organizations, and corruption. Other than that, it's a lovely place enriched with various cultures. The City Centre consists of a Main square surrounded by shops and many other businesses. A beautiful gothic fountain is the centerpiece of this square, and north of it lies The City Council building. As a young detective from down south, you begin to feel a bit overwhelmed.

You can see Morgana and Sigmund here.

>go west
Victor's workshop
Victor is an engineer. He makes weapons and various other tools used by police and military. It's rumored that he also pracitces some kind of magic, but you are not the one to fall for rumors, are you? The workshop reeks of garlic.

You can see Victor Volturi, a chest (closed), Garlic bread and a gun here.

>take Garlic Bread
You jot down the details of "Garlic bread" in your notebook.

>examine notebook
You review your notes:shiny scroll: If you wish to become a creature of the night, you shall come to me mortal and I shall grant you your wish. Come to my nest, little bird. Fear me not.
Garlic bread: Vampires don't really like garlic - must suck if they are Italian.
mirror: I look unrecognizable.
torn document: A fragment of parchment with faded writing in a strange language. But I can feel it calling me.

The sun rises, and the city starts to stir again.

>inventory
You are carrying:
  Garlic bread
  a shiny scroll
  a torn document
  a mirror
  a garlic
  a workshop key
  a note 1
  a vault key
  Photograph
  an onions
  a teleportation stone
  a notebook

>ask Victor Volturi about gin
"I don't have much to say about that," Victor grumbles, returning to his work.

>ask Victor Volturi about gun
"Take it. It's made for you. Your boss payed me up front."

>inventory
You are carrying:
  Garlic bread
  a shiny scroll
  a torn document
  a mirror
  a garlic
  a workshop key
  a note 1
  a vault key
  Photograph
  an onions
  a teleportation stone
  a notebook

>take gun
Taken.

>inventory
You are carrying:
  a gun
  Garlic bread
  a shiny scroll
  a torn document
  a mirror
  a garlic
  a workshop key
  a note 1
  a vault key
  Photograph
  an onions
  a teleportation stone
  a notebook

>go west
You can't go that way.

>go east
New Volterra - City Centre
The City of New Volterra is a, heh, lively metropolitan area inhabited by both people and nightfolk. Nightfolk include vampires, werewolves, ghouls, and many others. Like any other bigger city, New Volterra has its troubles such as the rise of dark magic, criminal organizations, and corruption. Other than that, it's a lovely place enriched with various cultures. The City Centre consists of a Main square surrounded by shops and many other businesses. A beautiful gothic fountain is the centerpiece of this square, and north of it lies The City Council building. As a young detective from down south, you begin to feel a bit overwhelmed.

You can see Morgana and Sigmund here.

>go east
Bloodless Nest
You step into a dimly lit chamber with stone walls covered in carvings. Faint whispers echo through the halls, and the air smells of iron and decay. It's hard to shake the feeling that you're being watched.

The sun sets, and the city grows mystic as night falls.

>go east
East Wing
The East Wing is a narrow corridor with flickering torches casting long shadows. You see several ornate doors along the walls, some ajar, revealing what looks like storage rooms.

You can see Grog and a blood sample here.

>take blood sample
You jot down the details of "blood sample" in your notebook.

>go to Market
Market
Lively area filled with vendors and interesting things.

You can see Cecilia, Gaiman, a Book of The Undead and a Blood Pudding here.

The teleportation stone glows, and the world blurs. When your vision clears, you find yourself in Market.

>examine Cecilia
Mhm, yep, that's a vampire.

>examine Cecilia
Mhm, yep, that's a vampire.

>examine Cecilia
Mhm, yep, that's a vampire.

The sun rises, and the city starts to stir again.

>ask Gaiman about merch
"Damn right I got merch. Buy your heart out kid."
"No haggling.."
1. "Onions"
2. "Book of The Undead"
3. "Blood Pudding"

>3
That's nasty but there you go

>go west
You can't go that way.

>go to Bloodless nest
Bloodless Nest
You step into a dimly lit chamber with stone walls covered in carvings. Faint whispers echo through the halls, and the air smells of iron and decay. It's hard to shake the feeling that you're being watched.

The teleportation stone glows, and the world blurs. When your vision clears, you find yourself in the Bloodless Nest.

>go east
East Wing
The East Wing is a narrow corridor with flickering torches casting long shadows. You see several ornate doors along the walls, some ajar, revealing what looks like storage rooms.

You can see Grog here.

>give Grog Blood Pudding
His eyes lit. He disgustingly eats the blood pudding with his bare hands. A card falls to the floor from his cloak. You swiftly take it.

>inventory
You are carrying:
  a card
  a Blood Pudding
  a blood sample
  a gun
  Garlic bread
  a shiny scroll
  a torn document
  a mirror
  a garlic
  a workshop key
  a note 1
  a vault key
  Photograph
  an onions
  a teleportation stone
  a notebook

>go east
You can't go that way.

>go west
Bloodless Nest
You step into a dimly lit chamber with stone walls covered in carvings. Faint whispers echo through the halls, and the air smells of iron and decay. It's hard to shake the feeling that you're being watched.

>go west
West Wing
The West Wing is a wide hallway with a vaulted ceiling and stained-glass windows that let in pale moonlight. At the end of the hall, a locked iron door catches your attention.

You can see an Iron Door here.

The sun sets, and the city grows mystic as night falls.

>unlock Iron Door
What do you want to unlock the Iron Door with?

>unlock Iron Door witch card
I didn't understand that sentence.

>unlock Iron Door with card
You slide the card through a hidden slot in the door. With a low rumble, the Iron Door creaks open, revealing the Throne Room.

>go south
(first opening the Iron Door)

Throne Room
A grand chamber with high ceilings and a sense of foreboding. At the center, seated on a dark, ornate throne, is the Grand Vampire himself, his presence dominating the space.

You can see an Iron Door and a Grand Vampire here.

>examine Grand Vampire
Mhm, yep, that's a vampire.

>ask Grand Vampire about blood bank
"YOU ARRRE AWARRRE THAT... MY KIND MUST EATTTT..." The room shakes with his voice.

>ask Grand Vampire about crime
"..."

>ask Grand Vampire about blood
"..."

>ask Grand Vampire about crimes
"I COMMITTTED NO CRRRRRIME... MY SERRRVANTS HUNT FORRR ME."

>ask Grand Vampire about servants
"THOSE TO WHOM I GRRRRANT ETERRRRNAL LIFE."

>ask Grand Vampire about eternal life
"DO YOU WISH TO LIVE IT?"
"The choice is yours, kid."
4. "Become a vampire."
5. "Bring justice - Kill him."
6. "Do nothing."

The sun rises, and the city starts to stir again.

>5
YOU DARRREEE TO OPPOSSEEE ME?"

>kill Grand Vampire
You can only kill the grand vampire at night.

>ask Grand Vampire about eternal life
"DO YOU WISH TO LIVE IT?"
"The choice is yours, kid."
4. "Become a vampire."
5. "Bring justice - Kill him."
6. "Do nothing."

>6
....

>6
....

>66
That's not a verb I recognise.

>5
YOU DARRREEE TO OPPOSSEEE ME?"

>examine Grand Vampire
The King of all Vampires. His presence is frightening and dark but there is something calling you to him...You must resist it. Remember - you are a detective. Forget about your foolish fantasies of becoming a vampire. Be honorable. Do the right thing...For yourself?

>examine Grand Vampire
The King of all Vampires. His presence is frightening and dark but there is something calling you to him...You must resist it. Remember - you are a detective. Forget about your foolish fantasies of becoming a vampire. Be honorable. Do the right thing...For yourself?

>examine Grand Vampire
The King of all Vampires. His presence is frightening and dark but there is something calling you to him...You must resist it. Remember - you are a detective. Forget about your foolish fantasies of becoming a vampire. Be honorable. Do the right thing...For yourself?
The sun sets, and the city grows mystic as night falls.

>kill Grand Vampire
You strike down the Grand Vampire, killing it instantly!

    *** You did it. You really killed him. Your journey ends here and you are free to go back home. Cheif will reward you handsomely. ***

Would you like to RESTART, RESTORE a saved game, QUIT or UNDO the last command?